{
	"width": 12,
	"height": 12,
	"floor": 0,
	"ceiling": 1,
	"collisionMap": [
		[1, 1, 1, 1, 1, 1, 1, 1, 1, 1, 1, 1],
		[1, 0, 0, 0, 0, 0, 0, 0, 0, 0, 0, 1],
		[1, 0, 0, 0, 0, 0, 0, 0, 0, 0, 0, 1],
		[1, 1, 0, 0, 0, 0, 0, 0, 0, 0, 0, 1],
		[1, 0, 0, 0, 0, 0, 0, 0, 0, 0, 0, 1],
		[1, 0, 0, 0, 0, 0, 0, 0, 0, 0, 0, 1],
		[1, 0, 0, 0, 0, 0, 0, 0, 0, 0, 0, 1],
		[1, 0, 0, 0, 0, 0, 0, 0, 0, 0, 0, 1],
		[1, 0, 0, 0, 1, 0, 0, 0, 0, 0, 0, 1],
		[1, 0, 0, 0, 1, 0, 0, 0, 0, 0, 0, 1],
		[1, 0, 0, 0, 1, 0, 0, 0, 0, 0, 0, 1],
		[1, 1, 1, 1, 1, 1, 1, 1, 1, 1, 1, 1]
	],
	"textureMap": [
		[0, 0, 0, 0, 0, 0, 0, 0, 0, 0, 0, 0],
		[0, 0, 0, 0, 0, 0, 0, 0, 0, 0, 0, 0],
		[0, 0, 0, 0, 0, 0, 0, 0, 0, 0, 0, 0],
		[0, 4, 0, 0, 0, 0, 0, 0, 0, 0, 0, 0],
		[0, 0, 0, 0, 0, 0, 0, 0, 0, 0, 0, 0],
		[0, 0, 0, 0, 0, 0, 0, 0, 0, 0, 0, 0],
		[0, 0, 0, 0, 0, 0, 0, 0, 0, 0, 0, 0],
		[0, 0, 0, 0, 0, 0, 0, 0, 0, 0, 0, 0],
		[0, 0, 0, 4, 4, 0, 0, 0, 0, 0, 0, 0],
		[0, 0, 0, 0, 4, 0, 0, 0, 0, 0, 0, 0],
		[0, 0, 0, 0, 4, 0, 0, 0, 0, 0, 0, 0],
		[0, 0, 0, 0, 0, 0, 0, 0, 0, 0, 0, 0]
	],
	"lightMap": [
		[0, 0, 0, 0, 0, 0, 0, 0, 0, 0, 0, 0],
		[0, 0, 1, 0, 0, 0, 0, 0, 0, 0, 0, 0],
		[0, 0, 0, 0, 0, 0, 0, 0, 0, 0, 0, 0],
		[0, 0, 0, 0, 0, 0, 0, 0, 0, 0, 0, 0],
		[0, 0, 0, 0, 0, 0, 0, 0, 0, 0, 1, 0],
		[0, 0, 0, 0, 0, 0, 0, 0, 0, 0, 0, 0],
		[0, 1, 0, 0, 0, 0, 0, 0, 0, 0, 0, 0],
		[0, 0, 0, 0, 0, 0, 0, 0, 0, 0, 0, 0],
		[0, 0, 0, 0, 0, 0, 0, 0, 0, 0, 0, 0],
		[0, 0, 0, 0, 0, 0, 0, 0, 0, 0, 0, 0],
		[0, 0, 1, 0, 0, 0, 0, 0, 0, 0, 0, 0],
		[0, 0, 0, 0, 0, 0, 0, 0, 0, 0, 0, 0]
	],
	"scripts": [
		{
			"id": 0,
			"type": "ladder",
			"collision": false,
			"texture": ["panel-1", "panel-1", "panel-1", "panel-1", "panel-1", "ladder-0"],
			"x": 1,
			"y": 2
		},
		{
			"id": 1,
			"type": "loot",
			"name": "armor",
			"collision": false,
			"texture": ["armor-0"],
			"x": 4,
			"y": 5
		}
	]
}
