{
	"width": 12,
	"height": 12,
	"floor": "floor-0",
	"ceiling": "floor-1",
	"collisionMap": [
		[1, 1, 1, 1, 1, 1, 1, 1, 1, 1, 1, 1],
		[1, 0, 0, 1, 0, 0, 0, 0, 0, 0, 0, 1],
		[1, 0, 0, 0, 0, 0, 0, 0, 0, 0, 0, 1],
		[1, 0, 0, 0, 0, 0, 0, 0, 0, 0, 0, 1],
		[1, 0, 0, 0, 0, 0, 0, 0, 1, 1, 1, 1],
		[1, 0, 0, 0, 0, 0, 0, 0, 0, 0, 0, 1],
		[1, 0, 0, 0, 0, 0, 0, 0, 0, 0, 0, 1],
		[1, 0, 0, 0, 0, 0, 0, 0, 0, 0, 0, 1],
		[1, 0, 0, 0, 0, 0, 0, 0, 0, 0, 0, 1],
		[1, 0, 0, 0, 0, 0, 0, 0, 0, 0, 0, 1],
		[1, 0, 0, 0, 0, 0, 0, 0, 0, 0, 0, 1],
		[1, 1, 1, 1, 1, 1, 1, 1, 1, 1, 1, 1]
	],
	"textureMap": [
		[0, 0, 0, 0, 0, 0, 0, 0, 0, 0, 0, 0],
		[0, 0, 0, 4, 0, 0, 0, 0, 0, 0, 0, 0],
		[0, 0, 0, 0, 0, 0, 0, 0, 0, 0, 0, 0],
		[0, 0, 0, 0, 0, 0, 0, 0, 0, 0, 0, 0],
		[0, 0, 0, 0, 0, 0, 0, 0, 4, 4, 4, 0],
		[0, 0, 0, 0, 0, 0, 0, 0, 0, 0, 0, 0],
		[0, 0, 0, 0, 0, 0, 0, 0, 0, 0, 0, 0],
		[0, 0, 0, 0, 0, 0, 0, 0, 0, 0, 0, 0],
		[0, 0, 0, 0, 0, 0, 0, 0, 0, 0, 0, 0],
		[0, 0, 0, 0, 0, 0, 0, 0, 0, 0, 0, 0],
		[0, 0, 0, 0, 0, 0, 0, 0, 0, 0, 0, 0],
		[0, 0, 0, 0, 0, 0, 0, 0, 0, 0, 0, 0]
	],
	"lights": [
		{
			"x": 2,
			"y": 1
		},
		{
			"x": 1,
			"y": 6
		},
		{
			"x": 10,
			"y": 4
		},
		{
			"x": 2,
			"y": 10
		}
	],
	"scripts": [
		{
			"id": 0,
			"type": "ladder",
			"collision": false,
			"texture": ["panel-1", "panel-1", "panel-1", "panel-1", "panel-1", "ladder-0"],
			"x": 1,
			"y": 2
		},
		{
			"id": 1,
			"type": "loot",
			"name": "armor",
			"collision": false,
			"texture": ["armor-0"],
			"x": 4,
			"y": 5
		}
	]
}
